12 12 12 12 12 12 12 12 12
11 00 00 00 00 00 00 00 11
11 03 03 03 03 03 03 03 11
11 02 02 02 02 02 02 02 11
11 01 01 01 01 01 01 01 11
11 00 00 00 00 00 00 00 11
11 00 02 00 02 00 02 00 11
11 00 00 00 00 00 00 00 11
11 00 00 00 00 00 00 00 11
11 00 00 00 00 00 00 00 11
11 00 00 00 00 00 00 00 11
11 00 00 00 00 00 00 00 11
11 00 00 00 00 00 00 00 11
11 00 00 00 00 00 00 00 11
11 00 00 00 00 00 00 00 11
11 00 00 00 00 00 00 00 11
11 00 00 00 00 00 00 00 11
11 00 00 00 00 00 00 00 11
11 00 00 00 00 00 00 00 11
11 00 00 00 00 00 00 00 11
11 10 10 10 10 10 10 10 11